NO ./textures/book1_1.xpm
SO ./textures/book2.xpm
WE ./textures/book1_1.xpm
EA ./textures/book2.xpm
DO ./textures/door2.xpm
S ./textures/Attack_3.xpm

F 118,59,25
C 255,255,255

1111111111111111111
1201001001001021001
1001001001001001001
1001001001001001001
1001001020001001001
100000000000S002001
100001111111D111111
1111000000000001111
1000020101010000001
1111111111111111111